***************
*1R    -    L3*
* *-*-*-*-*-* *
*-------------*
*-*-*-*-*-*-*-*
*-----   -----*
*-*-*-*5*-*-*-*
*-----   -----*
*-*-*-*-*-*-*-*
*-------------*
* *-*-*-*-*-* *
*4R    -    L2*
***************
