***************
*1RD   -   DL3*
* *-*-*-*-*-* *
*--R-------L--*
*-*-*-*-*-*-*-*
*----- L -----*
*-*-*-*5*-*-*-*
*----- R -----*
*-*-*-*-*-*-*-*
*--R-------L--*
* *-*-*-*-*-* *
*4RU   -   UL2*
***************
